~~~########
~~##...#..#
~##...##..#
##........#
#...@...###
#####.....#
~~#.###...#
~##...#..##
~#..##..##
~#.....##
~#######