~~~########~~#########
~~##...#..#~~#V.....V#
~##...##..#~~#.......#
##........#~~####.####
#....@..######V......#
#####................#
~~#.###...####..#.#..#
~##..V#..##~~#########
~#..##..##
~#.....##
~#######