~~~########~~#########
~~##...#..#~~#v.....v#
~##...##..#~~#.......#
##........#~~####.####
#....@..######v......#
#####............D...#
~~#.###...####..#.#..#
~##..v#..##~~#########
~#..##..##
~#.....##
~#######