###########
#vS.......#~~~############
#####..#bt#~~~#S..#c#..tb#
#t.....#########........S#
#v..@..............v######
####......######........t#
#SS#.######~~~#S.c#.#S#tt#
#.......vv#~~~#####.######
#..#....##~~~~#cvc..#
#SS#..v##~~~~~#cS..c#
########~~~~~~#vScSc#
~~~~~~~~~~~~~~#######