###########
#.........#
#.........#
#.........#
#...@.....#
#.........#
#.........#
#.........#
#.......##
#......##
########