######################
#S....Sb#cSmS.vt#...v#
###m.####.......m...##
#.......#S#c#S#c#...t#
#S...@..##########.###
##m##...#c#S#S#c#...b#
#...#...........m...##
#St.#..c#....S.S#....#
##########.###########
~#c#t#cv#m.m#~~~~~~~~~~
~#S....##m.m###########
~####m##m...b#c.c.ccvc#
~#c...S###.######.##v##
~#v.#.....m.........S.#
~#S..mv######cS#c#S#.v#
~#######~~~~###########