###########
###########
###########
####.######
#...@.....#
####.######
###########
###########
###########
###########