###########
#vS.......#~~~############
#####..#bt#~~~#S..#c#..tb#
#t.....#########........S#
#v..@........m.....v######
####......######........t#
#SS#m######~~~#S.c#.#S#tt#
#.......vv#~~~#####m######
#..#....##~~~~#cvc..#
#SS#..v##~~~~~#cS..c#
########~~~~~~#vS.Sc#
~~~~~~~~~~~~~~###m###
#############~~~#.#
#.t.St#tb#.v#####.#
#.S......S........#
#######.S##########
#S...v#..#SS#
#S..S......S#
#############