######################
#S....Sb#cSmS.vt#...v#
###m.####.......m...##
#.......#S#c#S#c#...t#
#S...@..##########.###
##m##...#c#S#S#c#...b#########
#...#...........m...##.S.v#ct#
#St.#..c#....S.S#S.........Sv#
##########.###########v.SS#vb#
~#c#t#cv#m.m#~~~~~~~~#########
~#S....##m.m###########
~####m##m...b#c.c.ccvc#
~#c...S###.######.##v##
~#v.#...............S.#
~#S..mv######cS#c#S#.v#
~#######~~~~###########